111111111
100P00001
110000001
111C000C1
1000E0001
10000C001
111111111
