111111111111
1P0C01E00001
111111111111